11111111111111111111111
10000010000101000001011
1010000000C011P00000001
10000000000011111000011
10000000000011100000001
10000000000011000000111
10000000000000000000E11
11111111111111111111111