111111111111111111111111111111111111111111111111111
1E0000000C000000000000C00C01111C0000000000000000001
1000000000000000C1100000000111100000000C00000000001
111111111111111001111000C00000000111111110000100001
1C0CCCC000000000011C0000000111110000000000011111111
111111111111011100000001111111111000000000111000001
1C0000000000011100001111111C00000011111100000000CP1
111111111111111111111111111111111111111111111111111